# -------------- VM  version 1.1 ------------- #
#                                              #
# 42 / filler VM Developped by: Hcao - Abanlin #
#                                              #
# -------------------------------------------- #
launched ./rabougue.filler
$$$ exec p1 : [./rabougue.filler]
launched resources/players/abanlin.filler
$$$ exec p2 : [resources/players/abanlin.filler]
Plateau 24 40:
    0123456789012345678901234567890123456789
000 OOOOOOXXXXXXXXXXXXXXXXXXXXXXXXXXXXXXXXXX
001 OOOOOOOXXXXXXXXXXXXXXXXXXXXXXXXXXXXXXXXX
002 OOOOOOOXXXXXXXXXXXXXXXXXXXXXXXXXXXXXXXXX
003 OOOOOXXXXXXXXXXXXXXXXXXXXXXXXXXXXXXXXXXX
004 .OOOOOXXXXXXXXXXXXXXXXXXXXXXXXXXXXXXXXXX
005 OOOOOOXXXXXXXXXXXXXXXXXXXXXXXXXXXXXXXXXX
006 .OOOOOOXXXXXXXXXXXXXXXXXXXXXXXXXXXXXXXXX
007 OOOOOOOXXXXXXXXXXXXXXXXXXXXXXXXXXXXXXXXX
008 OOOOOOOOOOXXXOXXXXXXXXXXXXXXXXXXXXXXXXXX
009 OOOOOOOOXXXXOOXXXXXXXXXXXXXXOOXXXXXXXOOX
010 .OOOOOOOOOOXOOOXXXOOOXXXOOOOOOXXXXXXXOOO
011 OOOOOOOOOOOOOOOOOOOOO.OOOOOOOOOOXXXXOOOO
012 OOOOOOOOOOOOOOOOOOOOOOOOOOOOOOOOOXXOOOOO
013 OOOOOOOOOOOOOOOOOO.OOOOO.OOOOOOOOXOOOOOO
014 .OOOOOO..OO...OO.OO.OOOOOOOOOOOOOXXOOOOO
015 OOOOOOOOOOOOOO.OOOOOOOOOOOOOOOOOOXOOOOOO
016 OOOOO.oo.....OOOOOOOOOOOOOOOOOOOOXXOOOOO
017 O...Oooo.......OOO..O.OOOOOOOOOOOOXXOOOO
018 ..OOO...........OO.OOOOOOOOOOOOOXXXXOOOO
019 ....O...........OOOOOOOOOOOOOOOOXXOOOOOO
020 ..................OOOOOOOOOOOOOOOOOOOOOO
021 ...................OOOOOOOOOOOOOOOOOOOOO
022 ....................OO..OOOOOOOOOOOOOOOO
023 ........................OOOOOOOOOOOOOOOO
Piece 2 6:
.***..
......
