# -------------- VM  version 1.1 ------------- #
#                                              #
# 42 / filler VM Developped by: Hcao - Abanlin #
#                                              #
# -------------------------------------------- #
launched ./rabougue.filler
$$$ exec p1 : [./rabougue.filler]
launched resources/players/abanlin.filler
$$$ exec p2 : [resources/players/abanlin.filler]
Plateau 24 40:
    0123456789012345678901234567890123456789
000 OOOOOOOXXXXXXXXXXXXXXXXXXXXXXXXXXXXXXXX.
001 OOOOOOOXXXXXXXXXXXXXXXXXXXXXXXXXXXXXXXX.
002 OOOOOOOXXXXXOXXXXXXXXXXXXXXXXXXXXXXXXXX.
003 OOOOOOOOOXOOOXXOXXXXXXXXXXXXXXXXXXXXXXX.
004 OOOOOOOOOOOOOOOOXXXXXXXXXXXXXXXXXXXXXXX.
005 OOOOOOOOOOOOOOOOXXXXXXXXXXXXXXXXXXXXXXX.
006 OOOOOOOOOOOOOOOOXXXXXXXXXXXXXXXXXXXXXXX.
007 OOOOOOOOOOOOOOOXXXXXXXXXXXXXXXXXXXXXXXX.
008 OOOOOOOOOOOOOOOOXXXXXXXXXXXXXXXXXXXXXXX.
009 OOOOOOOOOOOOOOOOOXXXXXXXXXXXXXXXXXXXXXX.
010 OOOOOOOOOOOOOOOOXXXXXXXXXXXXXXXXXXXXXXX.
011 OOOOOOOOOOOOOOOOXXXXXXXXXXXXXXXXXXXXXXX.
012 OOOOOOOOOOOOOOOOOXXXXXXXXXXXXXXXXXXXXXX.
013 OOOOOOOOOOOOOOOXXXXXXXXXXXXXXXXXXXXXXXX.
014 OOOOOOOOOOOOOOOOOXXXXXXXXXXXXXXXXXXXXXXO
015 OOOOOOOOOOOOOOOOOOOOOOOXXXXXXXXXXXXXXXXO
016 OOOOOOOOOOOOOOOOOOOOOOOOXXXXXXXXXXXXXXOO
017 OOOOOOOOOOOOOOOOOOOOOOOOXX.XXXOOOXOOOOOO
018 OOOOOOOOOOOOOOOOOOOOOOOOXXXOOOOOOOOOOOOO
019 OOOOOOOOOOOOOOOOOOOOOOOOOXXXXXXXXOOOOOO.
020 OOOOOOOOOOOOOOOOOOOOOOOOOOOOOOOOOOOOOOOO
021 OOOOOOOOOOOOOOOOOOOOOOOOOOOOOOOOOOOOOOOO
022 OOOOOOOOOOOOOOOO.OO.OOOOO..OOO.OO.OO..O.
023 1..OOO.OO.OOOO.......OOOOOOOOOOOOOOOOOOO
Piece 3 7:
......*
.....**
......*
