# -------------- VM  version 1.1 ------------- #
#                                              #
# 42 / filler VM Developped by: Hcao - Abanlin #
#                                              #
# -------------------------------------------- #
launched ./rabougue.filler
$$$ exec p1 : [./rabougue.filler]
launched resources/players/abanlin.filler
$$$ exec p2 : [resources/players/abanlin.filler]
Plateau 24 40:
    0123456789012345678901234567890123456789
000 OOOOOOOOOOOOOOOOOOOOOOOOOOOOOOOOO.OOOOOO
001 OOOOOOOOOOOOOOOOOOOOOOXOXOO.XO.OOXOOOOOO
002 OOOOOOOOOOOOOOOOOOOXXXXXXXXXXXXXXXXOOOOO
003 OOOOOOOOOOOOOOOOOOOOXXXXXXXXXXXXXXXOOOOO
004 OOOOOOOOOOOOOOOOOOOOOXXXXXXXX.X.XXOOOOOO
005 OOOoOOOOOOOOOOOOOOXXXXXXXXXXXXXXXXOOOOOO
006 OOOoOOOOO.OOOOOOOOXXXXXXXXXXXXXXXOOOOOOO
007 OOOOOOOOOOOOOOOOXXXXXXXXXXXXXXXXXXOOOOOO
008 OOOOOOOOOOOOOOOOXXXXXXXXXXXXXXXXXXXOOOOO
009 OOOOO.OOOOOOOOXXXXXXXXXXXXXXXXXXXXXXOOOO
010 OOOOOOOOOOOOOOXXXXXXXXXXXXXXXXXXXXXXXOOO
011 OOOOOOOOOOOOOXXXXXXXXXXXXXXXXXXXXXXXXXOO
012 .OOOOOOOOOOOOXXXXXXXXXXXXXXXXXXXXXXX..XO
013 .OOOOOOOOOOOOOOOOXXXXXXXXXXXXXXXXXXXXXXO
014 .OO.OOOOOOOOOOOOXXXXXXXXXXXXXXXXXXXXXOOO
015 OOOOOOOOOOOOOOOOOXXXXXXXXXXXXXXXXXXXOOOO
016 OOOOOOOO..OOOOOOOOXXXXXXXXXXXXXXXXXXXOOO
017 .OOOO.OOOOOOOOOOOOXXXXXXXXXXXXXXXXXXOOOO
018 .OOOOOOOOOOOOOOOOOXXXXXXXXXXXXXXXOOOOOOO
019 .OOOOOOOOOOOOOOOOOOOXXXXXXXXXXXXXOOOOOOO
020 .OOOOOOOOO.OOOOOOOOOOOXOXXXXOOOOOOOOOOOO
021 .OOO.OOOOOOOOOOOOOOOOOOOXOOOOOOOOOOOOOOO
022 .OO.OOOOO.OOOOOOOOOO.OOOOOOOOOOOOOOOOOOO
023 ....OOOOO.....OOOOO....OOOOOOOOOOOOOOOOO
Piece 4 6:
.*....
**....
**....
......
