....O......XXXXX........................
...Oo.......X..XX.......................
...Oo..........XX.......................
...OO...........X.......................
...OO...........X.......................
...OO...........X.......................
...OO...........X.......................
...O...........XX.......................
...OOOOOOO......XX......................
........OOOO.....X......................
...........O....XXX.....................
...........OO...XX......................
............O....X......................
............O.OXXXXX....................
............OOOO.XXXXXXX................
..............OO.......XXX..............
...............O........XX..............
...............O........XX..............
...............O........XXX.............
...............OOO.......XXXXXXXX.......
.................OOO....................
..................OOOOO.................
.................OO.OOO.................
.....................OOOOOO.............
