.............|..........................
.............|..........................
.............|..........................
.............|..........................
.......O.....|..........................
.............|..........................
.............|..........................
..++++++++++++..........................
.........................|..............
.........................|..............
.........................|..............
.........................|..............
.........................|..............
..======================p|..............
........................................
........................................
........................................
........................................
........................................
........................................
...............................X........
........................................
........................................
........................................
